######################################################################################
#                                        #####                                       #
#                                        #####                                       #
#     ##########     ###############     #####      ###############    ##########    #
#     ##########     ###############     #####      ###############    ##########    #
#     ##########     ###############     #####      ###############    ##########    #
#     ##########     ###############     #####      ###############    ##########    #
#                                                                                    #
#                                                                                    #
#     ##########     #####     #########################     #####     ##########    #
#     ##########     #####     #########################     #####     ##########    #
#     ##########     #####     #########################     #####     ##########    #
#                    #####               #####               #####                   #
#                    #####               #####               #####                   #
################     ###############     #####     ###############     ###############
################     ###############     #####     ###############     ###############
################     ###############     #####     ###############     ###############
################     #####                                   #####     ###############
################     #####                                   #####     ###############
################     #####     ##########|||||#########      #####     ###############
################     #####     #                      #      #####     ###############
################     #####     #                      #      #####     ###############
                               #                      #
                               #                      #
################     #####     #                      #      #####     ###############
################     #####     #                      #      #####     ###############
################     #####     ########################      #####     ###############
################     #####                                   #####     ###############
################     #####                                   #####     ###############
################     #####     #########################     #####     ###############
################     #####     #########################     #####     ###############
################     #####     #########################     #####     ###############
#                                        #####                                       #
#                                        #####                                       #
#     ##########     ###############     #####     ###############     #########     #
#     ##########     ###############     #####     ###############     #########     #
#     ##########     ###############     #####     ###############     #########     #
#          #####                                                       #####         #
#          #####                                                       #####         #
######     #####     #####     #########################     #####     #####    ######
######     #####     #####     #########################     #####     #####    ######
######     #####     #####     #########################     #####     #####    ######
#                    #####               #####               #####                   #
#                    #####               #####               #####                   #
#     ##############################     #####     #############################     #
#     ##############################     #####     #############################     #
#     ##############################     #####     #############################     #
#                                                                                    #
#                                                                                    #
######################################################################################
