######################################################################################
#                                        #####                                       #
#                                        #####                                       #
#     ###########    ###############     #####      ###############    ##########    #
#     ###########    ###############     #####      ###############    ##########    #
#     ###########    ###############     #####      ###############    ##########    #
#     ###########    ###############     #####      ###############    ##########    #
#                                                                                    #
#                                                                                    #
#     ###########    #####     #########################     #####     ##########    #
#     ###########    #####     #########################     #####     ##########    #
#     ###########    #####     #########################     #####     ##########    #
#                    #####               #####               #####                   #
#                    #####               #####               #####                   #
#################    ###############     #####     ###############     ###############
#################    ###############     #####     ###############     ###############
#################    ###############     #####     ###############     ###############
#################    #####                                   #####     ###############
#################    #####                                   #####     ###############
#################    #####     ##########|||||#########      #####     ###############
#################    #####     #                      #      #####     ###############
#################    #####     #                      #      #####     ###############
                               #                      #
                               #                      #
#################    #####     #                      #      #####    ################
#################    #####     #                      #      #####    ################
#################    #####     ########################      #####    ################
#################    #####                                   #####    ################
#################    #####                                   #####    ################
#################    #####     #########################     #####    ################
#################    #####     #########################     #####    ################
#################    #####     #########################     #####    ################
#                                        #####                                       #
#                                        #####                                       #
#    ############    ###############     #####     ###############    ##########     #
#    ############    ###############     #####     ###############    ##########     #
#    ############    ###############     #####     ###############    ##########     #
#          ######                                                     ######         #
#          ######                                                     ######         #
######     ######    #####     #########################     #####    ######    ######
######     ######    #####     #########################     #####    ######    ######
######     ######    #####     #########################     #####    ######    ######
#                    #####               #####               #####                   #
#                    #####               #####               #####                   #
#     ##############################     #####     #############################     #
#     ##############################     #####     #############################     #
#     ##############################     #####     #############################     #
#                                                                                    #
#                                                                                    #
######################################################################################
