######################################################################################
#                                        #####                                       #
#                                        #####                                       #
#     ##########     ###############     #####	    ###############     ########     #
#     ##########     ###############     #####	    ###############	########     #
#     ##########     ###############     #####	    ###############	########     #
#     ##########     ###############     #####      ###############	########     #
#									             #
#									             #
#     ##########     #####     #########################     #####     ##########    #
#     ##########     #####     #########################     #####     ##########    #
#     ##########     #####     #########################     #####     ##########    #
#                    #####               #####               #####                   #
#                    #####               #####               #####                   #
################     ###############     #####     ###############     ###############
#              #     ###############     #####     ###############     #             #
#              #     ###############     #####     ###############     #             #
#              #     #####                                   #####     #             #
#              #     #####                                   #####     #             #
#              #     #####     ##########|||||#########      #####     #             #
#              #     #####     #                      #      #####     #             #
################     #####     #                      #      #####     ###############
			       #		      #                               
                               #                      # 								             
################     #####     #                      #      #####     ###############
#              #     #####     #                      #      #####     #             #
#              #     #####     ########################      #####     #             #
#              #     #####                                   #####     #             #
#              #     #####                                   #####     #             #
#              #     #####     #########################     #####     #             #
#              #     #####     #########################     #####     #             #
################     #####     #########################     #####     ###############
#                                        #####                                       #
#                                        #####                                       #
#     ##########     ###############     #####     ###############     #########     #
#     ##########     ###############     #####     ###############     #########     #
#     ##########     ###############     #####     ###############     #########     #
#          #####                                                       #####         #
#          #####                                                       #####         #
######     #####     #####     #########################     #####     #####    ######
######     #####     #####     #########################     #####     #####    ######
######     #####     #####     #########################     #####     #####    ######
#                    #####               #####               #####                   #
#                    #####               #####               #####                   #
#     ##############################     #####     #############################     #
#     ##############################     #####     #############################     #
#     ##############################     #####     #############################     #
#                                                                                    #
#                                                                                    #
######################################################################################