########################################################################################
#                                       ########                                       #
#   #############   #################   ########   #################   #############   #
#   #############   #################   ########   #################   #############   #
#   #############   #################   ########   #################   #############   #
#   #############   #################   ########   #################   #############   #
#   #############   #################   ########   #################   #############   #
#                                                                                      #
#   #############   #######   ############################   #######   #############   #
#   #############   #######   ############################   #######   #############   #
#   #############   #######   ############################   #######   #############   #
#   #############   #######   ############################   #######   #############   #
#                   #######             ########             #######                   #
#################   #################   ########   #################   #################
#################   #################   ########   #################   #################
#################   #################   ########   #################   #################
#################   #################   ########   #################   #################
#################   #######                                  #######   #################
#################   #######   ##########||||||||##########   #######   ################# 
#################   #######   #                          #   #######   #################
#################   #######   #                          #   #######   #################
                              #                          #
#################   #######   #                          #   #######   ################# 
#################   #######   #                          #   #######   #################
#################   #######   #                          #   #######   #################
#################   #######   ############################   #######   #################
#################   #######                                  #######   #################
#################   #######   ############################   #######   #################
#################   #######   ############################   #######   #################
#################   #######   ############################   #######   #################
#################   #######   ############################   #######   #################
#                                       ########                                       #
#   #############   ################    ########   #################   #############   #
#   #############   ################    ########   #################   #############   #
#   #############   ################    ########   #################   #############   #
#   #############   ################    ########   #################   #############   #
#        ########                                                      ########        #
######   ########   #######   ############################   #######   ########   ######
######   ########   #######   ############################   #######   ########   ######
######   ########   #######   ############################   #######   ########   ######
######   ########   #######   ############################   #######   ########   ######
#                   #######             ########             #######                   #
#   #################################   ########   #################################   #
#   #################################   ########   #################################   #
#   #################################   ########   #################################   #
#   #################################   ########   #################################   #
#                                                                                      #
########################################################################################