######################################################################################
#                                        #######                                     #
#    #############   #################   #######   #################   ###########   #
#    #############   #################   #######   #################   ###########   #
#    #############   #################   #######   #################   ###########   #
#    #############   #################   #######   #################   ###########   #
#    #############   #################   #######   #################   ###########   #
#                                                                                    #
#    #############   #######   ###########################   #######   ###########   #
#    #############   #######   ###########################   #######   ###########   #
#    #############   #######   ###########################   #######   ###########   #
#    #############   #######   ###########################   #######   ###########   #
#                    #######             #######             #######                 #
##################   #################   #######   #################   ###############
##################   #################   #######   #################   ###############
##################   #################   #######   #################   ###############
##################   #################   #######   #################   ###############
##################   #######                                 #######   ###############
##################   #######                                 #######   ###############
##################   #######    ##########|||||#########     #######   ###############
##################   #######    #                      #     #######   ###############
##################   #######    #                      #     #######   ###############
                                #                      #
##################   #######    #                      #     #######  ################
##################   #######    #                      #     #######  ################
##################   #######    #                      #     #######  ################
##################   #######    ########################     #######  ################
##################   #######                                 #######  ################
##################   #######   ###########################   #######  ################
##################   #######   ###########################   #######  ################
##################   #######   ###########################   #######  ################
##################   #######   ###########################   #######  ################
#                                        #####                                       #
#    #############   #################   #####   ###################  ############   #
#    #############   #################   #####   ###################  ############   #
#    #############   #################   #####   ###################  ############   #
#    #############   #################   #####   ###################  ############   #
#          #######                                                    ########       #
########   #######   #######   ###########################   #######  ########  ######
########   #######   #######   ###########################   #######  ########  ######
########   #######   #######   ###########################   #######  ########  ######
########   #######   #######   ###########################   #######  ########  ######
#                    #######             #####               #######                 #
#    #################################   #####   #################################   #
#    #################################   #####   #################################   #
#    #################################   #####   #################################   #
#    #################################   #####   #################################   #
#                                                                                    #
######################################################################################
######################################################################################
