######################################################################################
#                                        #######                                     #
#    #############   #################   #######   #################   ###########   #
#    #############   #################   #######   #################   ###########   #
#    #############   #################   #######   #################   ###########   #
#    #############   #################   #######   #################   ###########   #
#    #############   #################   #######   #################   ###########   #
#                                                                                    #
#    #############   #######   ###########################   #######   ###########   #
#    #############   #######   ###########################   #######   ###########   #
#    #############   #######   ###########################   #######   ###########   #
#    #############   #######   ###########################   #######   ###########   #
#                    #######             #######             #######                 #
##################   #################   #######   #################   ###############
##################   #################   #######   #################   ###############
##################   #################   #######   #################   ###############
##################   #################   #######   #################   ###############
##################   #######                                 #######   ###############
##################   #######                                 #######   ###############
##################   #######   ##########|||||#########      #######   ###############
##################   #######   #                      #      #######   ###############
##################   #######   #                      #      #######   ###############
                               #                      #
##################   #######   #                      #      #######  ################
##################   #######   #                      #      #######  ################
##################   #######   #                      #      #######  ################
##################   #######   ########################      #######  ################
##################   #######                                 #######  ################
##################   #######   ##########################    #######  ################
##################   #######   ##########################    #######  ################
##################   #######   ##########################    #######  ################
##################   #######   ##########################    #######  ################
#                                        #####                                       #
#    #############   ################    #####    ##################  ###########    #
#    #############   ################    #####    ##################  ###########    #
#    #############   ################    #####    ##################  ###########    #
#    #############   ################    #####    ##################  ###########    #
#          #######                                                    #######        #
#######    #######   #######   ##########################    #######  #######   ######
#######    #######   #######   ##########################    #######  #######   ######
#######    #######   #######   ##########################    #######  #######   ######
#######    #######   #######   ##########################    #######  #######   ######
#                    #######             #####               #######                 #
#    #################################   #####   #################################   #
#    #################################   #####   #################################   #
#    #################################   #####   #################################   #
#    #################################   #####   #################################   #
#                                                                                    #
######################################################################################
######################################################################################
